111111111111
1T00110000C1
100CE110C001
1C00001000C1
1110C000T101
110000C0C011
1CT0C0000011
100000110001
10C10C1P00C1
100011110T01
1C000C1C0001
111111111111
