1111111
1C00C01
10T00E1
1P01C01
1111111