111111111111111111111
10000C0100001CC000C01
1C00C000C0C00T00CC001
100C10C0CC001100C0001
100110C010011C1000CC1
100100001E11C00C00001
1000CC00111C00P100CC1
1000T0000000001100001
1110000000C0001CC0001
111111111111111111111