111111111111
1PT0C1001C01
100C110C11C1
1C000C000001
101100TCC011
10C100C000E1
111111111111
