11111111111111111111111111111
10011C0000001CC000000C0110001
100C10C1CC00000CC0010T00C0001
1C0000C0C0C0000CC00000C000001
100C10C1CC000CCE00C000111CC01
10C011110000C00T0100C00011001
10011C0000001CC00011C00C110C1
1C0000P0C0C01100000CC000C1111
1C00TC00C0C01110000CC000C0111
1C000000C0C0010000CC00000C011
100C10C1CC0000CC1110000C0C0C1
100C10C0CC0010001C000CC0000C1
100011100C0C00111C00000001101
1C0000C0C0C001100CC00000CC001
1000111000C0C1CC00C0C00000C01
11111111111111111111111111111
