111111111111
1PT0C1001C01
100C110C11C1
1C000C000001
10110T0CC011
10C100C000E1
111111111111
