111111111111
100C110000C1
100CE11CC001
1C0000100CC1
1110C0000101
110000CCC011
1C00C000C011
100C00110001
10C10C1P0CC1
1C0011110001
10C00C1C0C01
111111111111