1111111
1C00C01
100C0E1
1P01C01
1111111
