111111111111
1CC00C0C0CE1
100C000C00C1
1C000PC00001
100C0C00CC01
111111111111
