111111111111
1E0110000001
100010000001
10000P000001
100000000001
100000000011
111111111111
