0011C000C0
0EC100C00C
C000PC0000
00C000CC00
0000CC0001