0011C000C0
0EC100C00C
C000PC0000
00C0T0CC00
0000CC0001