111111111111
1E011C000C01
100C100C00C1
1C00PPC00001
100C0T0CC001
10000CC00011
111111111111
