111111111111
1E011C000C01
100C1T0C00C1
1C001PC00001
100C100CC001
10001CC00011
111111111111
