111111111111
1E011C000C01
100C1001
1C000PC00001
100C000CCT01
10000CC00011
1111111111111
